####*################
####.#.##############
###..###..###########
##........###########
#...@..#..###########
###..################
#####################
#####################
#####################
#####################